NO xpm/texture_north.xpm
SO xpm/texture_south.xpm
WE xpm/texture_west.xpm
EA xpm/texture_east.xpm

F 120,120,120
C 170,210,255

        1111111111111111111111111
        1000000000110000000000001
        1011000001110000000000001
        1001000000000000000000001
111111111011100000111000000000001
10000000001 1000001110111111111111
11110111111111011100000010001
11110111111111011101010010001
11000000110101011100000010001
10000000000000001100000010001
10000000000000001101010010001
1100000110101011111011110N0111
11110111 1110101 101111010001
11111111 1111111 111111111111